000000000000000001
000111111111110001
000000010100010001
000000011111110011
111111110000000001
000100100001000101
000100100011111111
111111111010001000
100000000000101011
101110001111111010
101010101010100000
101010101010111111
111111111010101000
000000000000000000
222222222222222222



