000000000000000000
000111111111110002
000000010100010001
000000011111110011
111111110000000001
000100100001000101
000100100011111111
111111111010001010
100000000000101011
101110001111111110
101010101010100000
101010101010111111
111111111010101000
000000000000000000
222222222222222222